11111111111111111111111111111111111111111111111111
00000000000000000000000000000000000000000000001111
10101111111111111111111111111111111111111111111111
10100111111111111111111111111111111111111111111111
10110011111111111111111111111111111111111111111111
10111001111111111111111111111111111111111111111111
10111100111111111111111111111111111111111111111111
10111110011111111111111111111111111111111111111111
10111111001111111111111111111111111111111111111111
10111111100111111111111111111111111111111111111111
10111111110011111111111111111111111111111111111111
10111111111001111111111111111111111111111111111111
10111111111100111111111111111111111111111111111111
10111111111110011111111111111111111111111111111111
10111111111111001111111111111111111111111111111111
10111111111111100111111111111111111111111111111111
10111111111111110011111111111111111111111111111111
10111111111111111001111111111111111111111111111111
10111111111111111100000000000000000000000000000001
10111111111111111111111111111111111111111111111101
1011111111111111111111111111111111111111111111110x
10111111111111111111111111111111111111111111111101
10111111111111111111111111111111111111111111111101
10111111111111111111111111111111111111111111111101
10111111111111111111111111111111111111111111111101
11111111111111111111111111111111111111111111111111
11111111111111111111111111111111111111111111111111
11111111111111111111111111111111111111111111111111
11111111111111111111111111111111111111111111111111
11111111111111111111111111111111111111111111111111