111111111111111111111111111111
100001111111111111111111111111
001101111111111111111111111111
111101111000000001111111111111
111101110011011101111111111111
111100000111011101111111111111
111111110111011100001111111111
111111110000011111111111111111
111111111111011111111111111111
111111111111011111111111111111
111111111111011111111111111111
111111100000000000001111111111
111111101101111111101111111111
111111111100111111100000111111
111111111110111111101111111111
111111111110111111101111111111
111111111110111111100000000111
111111111111111110001111110111
111111111111111111111111110001
1111111111111111111111111111x1s
